_SSSSSSS_________P____SSSSSSS____SSSSSS__
_S______S________________S_______S_______
_S_______S_______S_______S_______S_______
_S______S________S_______S_______S_______
_S_____S_________S_______S_______SSSS____
_S______S________S_______S_______S_______
_S_______S_______S_______S_______S_______
_S________S______S_______S_______S_______
_S_________S_____S_______S_______S_______
_S_________S_____S_______S_______S_______
_S________S______S_______S_______S_______
_S_______S_______S_______S_______S_______
_SSSSSSSS________S_______S_______SSSSSSS_